1111111111111111111111111111
1PC0000000000000000000011111
1111111111111111110110011111
1111111111111111110110011111
1C00000000000001110110011111
1111111111111001110110011111
1111111111111101110110011111
1111111111101101110110011111
100000000E10110111C1100000C1
1001111111101101111110001111
1001111111101100000000000001
1000000000000001111111111111
1111111111111111111111111111
1111111111111111111111111111