1111111111111111111111111111
1P00000000000000000000000001
1000000000000000000000000001
1111111111111111100011000001
1C00000000000001100011000001
1000000000000001100011000001
1111111111100001100011001111
1111111111101101100011000001
100000000E10110110C0110000C1
1001111111101101111111001111
1001111111101100000000000001
1000000000001100000000000001
1000000000001100000000000001
1111111111111111111111111111
