111111111111
1PC000000001
10C0000000E0
111111111111