111111111111
1PC000000001
10C0000000E1
1111111111111
